NO /Users/abenmous/Desktop/Cub3d/Images/greystone.png
SO /Users/abenmous/Desktop/Cub3d/Images/bluestone.png
WE /Users/abenmous/Desktop/Cub3d/Images/purplestone.png
EA /Users/abenmous/Desktop/Cub3d/Images/redbrick.png

C 80,80,80
F 113,112,112

11111111111111111111111111111111111111
10000000000000000000000000000000000001
10000000001100000000000000000000000001
10000000000100000000000000000000000001
10000000000000000000000100000000000001
10000000000000000000000000000000111111
11110000000101000000000000000000100011
11110000000010S00000010000000000010111
11000000000000000000000000000001111111
1100000000000000000000000000001
1100000000000000000000000000001
1100000000000000000000000000001
1100000000000000000000000000001
1000000000000000000000000000001
1000000000000000000001000000001
1000000000000000000001000000001
1100000000000000000000000000001
1111111111111111111111111111111